1111111111111111
1000000000000001
1000000000000001
1001100000011001
1001000000001001
1000000000000001
1000000000000001
1001000000001001
1001000000001001
1000000000000001
1000000000000001
1001000000001001
1001100000011001
1000000000000001
1000000000000001
1111111111111111